5:5
0,0,0,0,0
0,5,4,6,0
0,7,0,8,0
0,2,1,3,0
0,0,0,0,0